11111111111111111111111111111111111111111111111111
11111111111111111111111111111111111111111111111111
11111111111111111111111111111111111111111111111111
11111111000000000000000000000000000000000000001111
11111111100000000000000000000000000000000000001111
11111111100000000000000000000000000000000000001111
11111111100000011111000000000000000000000000001111
11111111100000011111100000000000000111110000001111
11101111100000011111100000000000011111110000001111
11100000000000011111110000000000111111110000001111
11100000000000011111111000000011111111110000001111
11100000000000001111111000000111111111110000001111
11100000000000001111111100001111111111100000001111
11100000000000000111111110111111111110000000001111
11100000000000000011111111111111111100000000001111
11100000000000000011111111111111110000000000001111
11100000000000000001111111111111100000000000001111
11100000000000000000111111111111011111000000001111
11100000000000000000111111111100011111100000001111
11100011111000000000011111111111111111110000001111
11100011111000000000001111111111111111111100001111
11100011111111111111001111111111111111111110001111
11100011111111111111000111111111111111111110001111
11100011111111111111000011111111111111111110001111
11100011111111111111000000000111111111111110001111
11100011111111111111000000000011111100111110001111
11100011111000011111000000000011111100000000001111
11100011111000011111000000000001111100000000001111
11100011111000011111000000000001111100000000001111
11100011111000011111000000000001111100000000001111
11100011111000011111000000001111100000111110001111
11100011111000011111000000001111110000111111001111
11100011111000011111000000001111111000111111001111
11100000000000011111000000001111111000111111101111
11100000000000011111000000001111111100111111111111
11100000000000011111100000000111111110011111111111
11100000000000011111100000000011111111011111111111
11100000000000011111100000000011111111001111111111
11111111111111111111111111100001111111000111111111
11111111111111111111111111100000111111000011111111
11111111111111111111111111100000011111000000001111
11111111111111111111111111100000000000000000001111
11111111111111111111111111100000000000000000001111
00000000000000000000000000000000000000000000001111
00000000000000000000000000000000000000000000001111
00000000000000000000000000000000000000000000001111
00000000000000000000000000000000000000000000001111
11111111111111111111111111111111111111111111111111
11111111111111111111111111111111111111111111111111
11111111111111111111111111111111111111111111111111
11111111111111111111111111111111111111111111111111
